{
    "room-size": [1000, 800],
    "camera-active": true,
    "boundary": [72, 0, 800, 360],
    "camera-viewport": [800, 600],
    "player-init-action": "move-down",
    "player-init-position": [305, 350],
    "divarication": [
        [[305, 285], "home-entrance.json"]
    ],
    "background": {
       "Right": {
           "source-name": "ruins-tiles",
           "source-rects-path": "assets/ruins-rects.json",
           "tile-width": 20,
           "tile-height": 20,
           "tile-map-width": 40,
           "tile-map-height": 10,
           "tile-map": [
             7,7,7,28,28,28,7,7,7,7,7,5,5,5,7,7,7,7,7,19,19,19,7,7,7,7,7,7,7,7,7,7,7,7,7,7,7,7,7,7,
             7,7,28,22,22,22,28,7,7,7,5,22,22,22,5,7,7,7,19,22,22,22,19,7,7,7,7,7,7,7,7,7,7,7,7,7,7,7,7,7,
             7,7,28,22,22,22,28,7,7,7,5,22,22,22,5,7,7,7,19,22,22,22,19,7,7,7,7,7,7,7,7,7,7,7,7,7,7,7,7,7,
             7,7,28,22,22,22,28,7,7,7,5,22,22,22,5,7,7,7,19,22,22,22,19,7,7,7,7,7,7,7,7,7,7,7,7,7,7,7,7,7,
             10,10,18,18,18,18,18,10,10,10,11,11,11,11,11,10,10,10,18,18,18,18,18,10,10,10,10,10,10,10,10,10,10,10,10,10,10,10,10,10,
             10,10,10,18,18,18,10,10,10,10,10,11,11,11,10,10,10,10,10,18,18,18,10,10,10,10,10,10,10,10,10,10,10,10,5,5,5,5,5,5,
             10,10,10,10,10,10,10,10,10,10,10,10,10,10,10,10,10,10,10,10,10,10,10,10,10,10,10,10,10,10,10,5,5,5,12,25,12,12,12,23,
             10,10,10,10,10,10,10,10,10,10,10,10,10,10,10,10,10,10,10,10,10,10,10,10,10,10,10,10,5,5,5,23,12,27,23,12,12,12,27,12,
             3,3,3,3,3,3,3,3,3,3,3,3,3,3,3,3,3,3,3,3,3,3,3,3,3,3,3,3,23,12,27,12,25,12,12,12,25,12,23,12,
             3,3,3,3,3,3,3,3,3,3,3,3,3,3,3,3,3,3,3,3,3,3,3,3,3,3,3,3,12,25,12,23,12,12,27,23,12,27,12,25
           ]
       }
    },
    "background-rectangle": [0, 200, 1500, 1300]
}
