{
    "room-size": [320, 240],
     "camera-active": true,
     "room-background": {
        "Right": {
            "source-name": "ruins-tiles",
            "source-rects-path": "assets/ruins-rects.json",
            "tile-width": 20,
            "tile-height": 20,
            "tile-map-width": 40,
            "tile-map-height": 10,
            "tile-map": [
              7,7,7,28,28,28,7,7,7,7,7,5,5,5,7,7,7,7,7,42,42,42,7,7,7,7,7,7,7,7,7,7,7,7,7,7,7,7,7,7,
              7,7,28,22,22,22,28,7,7,7,5,22,22,22,5,7,7,7,42,22,22,22,42,7,7,7,7,7,7,7,7,7,7,7,7,7,7,7,7,7,
              7,7,28,22,22,22,28,7,7,7,5,22,22,22,5,7,7,7,42,22,22,22,42,7,7,7,7,7,7,7,7,7,7,7,7,7,7,7,7,7,
              7,7,28,22,22,22,28,7,7,7,5,22,22,22,5,7,7,7,42,22,22,22,42,7,7,7,7,7,7,7,7,7,7,7,7,7,7,7,7,7,
              10,10,18,18,18,18,18,10,10,10,11,11,11,11,11,10,10,10,41,41,41,41,41,10,10,10,10,10,10,10,10,10,10,10,10,10,10,10,10,10,
              10,10,10,18,18,18,10,10,10,10,10,11,11,11,10,10,10,10,10,41,41,41,10,10,10,10,10,10,10,10,10,10,10,10,5,5,5,5,5,5,
              10,10,10,10,10,10,10,10,10,10,10,10,10,10,10,10,10,10,10,10,10,10,10,10,10,10,10,10,10,10,10,5,5,5,56,58,56,56,56,23,
              10,10,10,10,10,10,10,10,10,10,10,10,10,10,10,10,10,10,10,10,10,10,10,10,10,10,10,10,5,5,5,23,56,60,23,56,56,56,60,56,
              3,3,3,3,3,3,3,3,3,3,3,3,3,3,3,3,3,3,3,3,3,3,3,3,3,3,3,3,23,56,60,56,58,56,56,56,58,56,23,56,
              3,3,3,3,3,3,3,3,3,3,3,3,3,3,3,3,3,3,3,3,3,3,3,3,3,3,3,3,56,58,56,23,56,56,60,23,56,60,56,58
            ]
        }
    }
}
